15.3 Step 3

For a more detailed look at your CPU's features, execute the following command:

cat /proc/cpuinfo

root@ubuntu:~# cat /proc/cpuinfo
processor   	: 0
vendor_id   	: GenuineIntel
cpu family  	: 6
model       	: 44
model name  	: Intel(R) Xeon(R)    	E5620 @2.40GHz
stepping    	: 2                                                        	 
microcode   	: 0x1                                                     	 
cpu MHz     	: 2393.992                                                 	 
cache size  	: 12288 KB                                                 	 
physical id 	: 0                                                 	 
siblings    	: 1                                                      	 
core id     	: 0                                                        	 
cpu cores   	: 1                                                        	 
apicid      	: 0                                                       	 
initial apicid  : 0                                                       	 
fpu         	: yes                                                      	 
fpu_exception   : yes                                                      	 
cpuid level 	: 11                                                       	 
wp          	: yes                                                      	 
flags:             	fpu vme de pse tsc msr pae mce cx8 apic sep mtrr pge mca cmov pat pse36 clflush mmx fxsr sse sse2 ss syscall nx pdpe1g rdtscp lm constant_tsc arch_perfmon rep_good nopl eagerfpu pni pclmulqdq ssse3 cx16 pcid sse4_1 sse4_2 x2apic popcnt tsc_deadline_timer aes hpervisor lahf_lm tsc_adjust arat
                                                          	 
bugs        	: cpu_meltdown spectre_v1 spectre_v2 spec_store_bypass l1tf
bogomips    	: 4787.98                                                  	 
clflush size	: 64    
cache_alignment : 64
address sizes   : 40 bits physical, 48 bits virtual
power management:

Note the highlighted flags: field in the output above. One of the key settings of the /proc/cpuinfo file is the flags that the CPU supports, which are a feature of the CPU. Some advanced CPU functions require specific flags.

